     R1400 900
NO./textures/purplestone.png

SO./textures/greystone.png
WE./textures/wood.png
EA./textures/eagle.png
S./textures/barrel.png


F255,0,0


C0,0,255






        1111111111111111111111111     11111
        1000000000110000000000001     10011
        1011000001110000002000001     11111
        1001000000000000000000001
1111111111011000001110000000000001
100000000011000001111111111111111
11110111111111011100000010201
11110111111111010101010010021
11000000110101011100000012001
10002000000000001100000002001
10000000000000001101010010001
1100000111010101111101111000111
11110111 1110101 1011110100S1
11111111 1111111 111111111111


